1121111111
000000K000
0w00000000
0w00000000
00000F0000
00G0000000
00000P0000
0000000000
0000000000
1111111111